111111111111111111111111111111111111111111111111111111111111111111111111111111111111
1NNN00000000000001111111111111111111111111111110000000001111111111111111111111111111
1NNN00000000000000011111111111111111111111111100000000000000011111111111111111111111
1NNN00000000000000000111111111111111111111111000000000000000001111111111111111111111
100000000001110000000001111111111111111111110000000000000000000000000000000000000001
100000000111000000100000011111111111111111100000000000000000000000000000000000000001
100000011100000001110000000111111111111111000000000000000000000000000000000000000001
100001110000000011111000000000000011000000000000000000000000000111110000000000000001
100111000000000111111100000000000011000000000000000000000000111111111110000000000001
111100000000001111111110000000000001100000000000000000111111111111111111110000000001
100000000000000111111111000000000000111111111111111111110000000001111111100000111111
100000000000000011111111100000000000000111111111111111000000000000001111000000001111
100000000000000001111111111111111000000000000000000000000000000000000000000000000111
111111100000000000111111111111111100000000000000000000000000000000000000000000000011
100001111111110000011111111111111111111111111111111111111111111111000000111111000001
100000000111110000001111111111111111111111111111111111111111111100000000000111111111
100000000000000000000000000000000000000000000000000001111111111000000000000000111111
100000000001111110000000000000000000000000000000000000111111100000000000000000001111
100000000000011111111111100000000000000000000000000000011110000000000000001111111111
100111000000000111111110000000111000000111111000000000001100000000000000000111111111
100001110000000001111100000011100000000001111000000000001100000000110000000011111111
100000011100000000111000001110000000000001111110000000001100000001111000000001111111
100000000111000000000000111000000000000001111111000000001100000011111100000000111111
100000000001110000000011100000000000000000000000000000001100000111111110000000011111
100000000000110000000011000000001111000000000000000000001100001111111111000000001111
100000000000110000000011000000011110000000000001111000000000011111111111100000000111
100000000000110000000011000000111100000000000001111000000000111111111111110000000011
100000000000110000000011000000011110000000000000000000000001111111111111111000000001
100000000000110000000011000000000111100000110000000000000001111111111111111111100001
100000000001110000000011100000000000000000110001111100000001111111111111111111100001
100000000111000000000000111000000000000000110000011100000000000000000000000001100001
100000011100000000000000001110000000000000110000011110000000000000000000000001100001
100001110000000000000000000011100000000000111000000000000111110000000000000001100001
100111000000000000000000000000111000000000111100000011111111111100000000000001100001
100000000000000000000000000000001110000000111110000001111111111111000000000001100001
100000000000011111111110000000000000000000111111000000000000000000000000000001100001
100000000001111111111111100000000000000000111111100000000000000000000000000001100001
100000000001111111111111111100000000000000111111110000000000000000000000000001100001
100000000000011111111111111111000000000000111111111111111111111111111100000001100001
100111111111111111111111111111111000000000111111111111111111111111111100000000000001
111110000000000000000000000000000000000000000000000000000000000000000000000000000001
111110000000000000000000000000000000000000000000000000000000000000000000000000000001
111111111111111111111111111111111111111100000001111111111111111111111111111111000001
11111111111111111111111111111111111111110000000111111111111111111111111111111100X001
1111111100000000000000000000000000000000000000000000000000000000000000000000000XXX01
11111111110000000000000000000000000000000000000000000000000000000000000000000000X001
111111111110000000000000000000000000000000000000000000000000000000000000000000000001
111111111111111111111111111111111111111111111111111111111111111111111111111111111111